Test
1
1
2
30
20
1,4;1,5;1,6
26,13;26,14;26,15

000000000000000000000000000000
033333222333333233333322222220
022233222332223333300322222220
022232333222223222000333332220
033333303222223222333332222220
032222003222233222322232222220
033222333322223332222232332220
033000232233333222222233332220
033333332222223222222232233220
032332222222223222222322223220
033332223333223111111332223220
103322222202311111111113323220
130322222333111111111113033220
130322222311111111111113033220
122332223111111111111112333220
122333331111111111111111113220
122003331111111111111111113331
133033033333330333333303333331
133333333303333333033333330331
111111111111111111111111111111
