Fourbase
2
1
4
1,1;3,2;2,3
30,1;28,2;29,3
2,28;3,29;1,30
28,29;29,28;30,30
32
32

00000000000000000000000000000000
03333333333333333333303333333330
03330331111111133303303303303330
03330331111111133303333303303330
03000331110000133300000003300030
03333331110222333333333033333330
03333331110222303331113033333330
03000332333303303331113221111130
03330002333303303331113331111130
03330333333303303333333331111130
00030311133303303222233330001130
03330311132003303222033332201130
03330311132223303222000002201130
03000333332223303333333332201130
03333333332223333333333333311130
03333333333333333300000000333330
03333300000000333333333333333330
03111333333333333332223333333330
03110223333333330332223333300030
03110220000022230332223111303330
03110223333022230330023111303330
03110003333222230330333111303000
03111113333333330330333333303330
03111113331113330330333320003330
03111112231113330330333323300030
03333333031113330322201113333330
03333333033333333322201113333330
03000330000000333100001113300030
03330330333330333111111113303330
03330330330330333111111113303330
03333333330333333333333333333330
00000000000000000000000000000000
